Whatever progress you had made in this night's vision is forgotten to you by now, and your illusionary avatar is fading from your mind's eye. Bright colors flash and flow before your eyes as you sink back to reality. You open your eyes and you can see the carved ceiling of your hut.  You are lying on the ground in the center of the hut, and feel incredibly weak and drowsy. You have awakened far too early from your vision quest, and need to rest before trying to move. 
Lifebound
An Interactive Fiction by Benjamin Strick
Release 1 / Serial number 150422 / Inform 7 build 6L38 (I6/v6.33 lib 6/12N) SD

Shaman's Hut (on the Woven Mat)
The hut has no furniture, and your important possessions are placed neatly on the floor.  A fire is crackling and the yearning starlight filters through the smoke chimney in your roof.  Local insects chirp and the sound of a rushing wind can be heard against the fabric of the tent.

You can see a Crackling Fire, an Insidious Artifact, a Bone Effigy, an Essence of the Jungle Toad, a Stone Totem, a Leather Lockbox (closed) and a Lifebind Necklace here.

>stand
You are too drowsy from your unfinished vision to stand yet.  There are lingering colors blinking in and out of existence, and the eerie whispers of lost ancestors still echo in your mind.

>touch stone totem
You immediately feel invigorated by the energy emitted through the pale rock.  Suddenly you feel that you could stand up, albeit carefully.  The totem itself looks brighter than usual....that indicates that perhaps Windwhisper has come to visit.

>open leather lockbox
That is too far away from your resting place to reach right now.

>stand
You get off the Woven Mat.

Shaman's Hut
The hut has no furniture, and your important possessions are placed neatly on the floor.  A fire is crackling and the yearning starlight filters through the smoke chimney in your roof.  Local insects chirp and the sound of a rushing wind can be heard against the fabric of the tent.

You can see a Woven Mat, a Crackling Fire, an Insidious Artifact, a Bone Effigy, an Essence of the Jungle Toad, a Stone Totem, a Leather Lockbox (closed) and a Lifebind Necklace here.

>open leather lockbox
You open the Leather Lockbox, revealing a Transient Orb.

>take transient orb
Taken.

A small, wounded Baby Jungle Panther slinks through the doorway to your hut.  It's back is wounded and bloody, and it limps pathetically toward you.  Its eyes are full of confusion and desperation.

>examine transient orb
It is a spherical object to commune with ancestral spirits for advice. All who call themselves a shaman in these lands possess one of these, for what is a shaman without ancestors to call upon?  Anyone with basic knowledge of shamanism could make one of these out of any object.  It is usually the color of earth, but can also turn black as night when it detects malignant intentions in those whose auras are clearly altered by their attempts to lie or deceive. Right now, your orb is black. 

A wave of confusion washes over you as you witness the abyssal color of your orb.  There must be evil nearby.  As you turn to look at the devious feline, you meet it's eyes and realize all too late what has happened. It gives you an oddly human look that tells you all you need to know.

Suddenly, you feel sure that this is a dark ancestral spirit inhabiting the body of this unfortunate jungle panther, and that it jealously desires the destruction of those living.  But something tells you this dark spirit is not here for YOUR life, but something else...

>attack cat
The cat reacts swiftly and swats all of your reminaing Essence of the Jungle Toad into the Crackling Fire.  The entire batch is set alight and your hut begins to fill with an overbearing smell that you know all too well.  You reach out to grab the cat, but before you can do anything a wave of ethereal images and voices assails your mind.  Before all goes dark, you feel a pang of fear as you realize just how much Essence you have inhaled... nearly one hundred fold the reccomended amount.

Shaman's Hut (on the Woven Mat)
The hut has no furniture, and your important possessions are placed neatly on the floor.  A fire is crackling and the yearning starlight filters through the smoke chimney in your roof.  Local insects chirp and the sound of a rushing wind can be heard against the fabric of the tent.

You can see a Crackling Fire, a Stone Totem, a Leather Lockbox (empty) and a Lifebind Necklace here.

>go n
(first getting off the Woven Mat)
You slowly snap back to reality, as otherworldy clouds, voices, and colors in your mind's eye fade.  It is night once again.  You experience a strange feeling of Deja Vu due to waking up from what was the most intense vision quest you have ever experienced.  In fact, you barely remember any of it... you just know it was more powerful than any other you've had. Something in your soul feels fundamentally altered.  You feel an odd mix of terror, vengeance, and urgency; suddenly you recall past events with the supposed panther cub. You look around in panic as you notice your Bone Effigy and Insidious Artifact are missing. You feel an additional spike of confusion as your solar calculations tell you that days have passed since you were last awake.

Jungle Enclave
You can feel the pulse of the jungle's raw mass of life in your bones.  Somewhere deep in your mind you are aware of the jungle denizen's hopeless struggle for prolonged existence.  Beasts, insects, and humans combined radiate out a desperate energy from their souls that you have learned to tune out.

>go w
The Path to the Painted Village
You can see a Fleshy Root here.

>go w
Village
Purple flame and smoke ravage the landscape.  A scent of death and soul energy tinges your nose.  Your heart sinks as you realize what has happened, but a small smile appears on your face.

You can see an Insidious Artifact here.

>look
Village
Purple flame and smoke ravage the landscape.  A scent of death and soul energy tinges your nose.  Your heart sinks as you realize what has happened, but a small smile appears on your face.

You can see an Insidious Artifact here.

* * *

>open leather lockbox
That is too far away from your resting place to reach right now.

>take transient orb
You can't see any such thing.

>examine transient orb
You can't see any such thing.

>stand
You get off the Woven Mat.

Shaman's Hut
The hut has no furniture, and your important possessions are placed neatly on the floor.  A fire is crackling and the yearning starlight filters through the smoke chimney in your roof.  Local insects chirp and the sound of a rushing wind can be heard against the fabric of the tent.

You can see a Woven Mat, a Crackling Fire, an Insidious Artifact, a Bone Effigy, an Essence of the Jungle Toad, a Stone Totem, a Leather Lockbox (closed) and a Lifebind Necklace here.

* * *

>give bone effigy
(to Baby Jungle Panther)
(first taking the Bone Effigy)
Baby Jungle Panther doesn't seem interested.

You share a glance of dark understanding with the being that stands before you.  It is time for vengeance against those who once spurned you.  The cat runs out of your hut and beckons for you to follow.

>go n
Your dark ally looks at you, then runs toward the path to the village where you were born.

>go s
Shaman's Hut
The hut has no furniture, and your important possessions are placed neatly on the floor.  A fire is crackling and the yearning starlight filters through the smoke chimney in your roof.  Local insects chirp and the sound of a rushing wind can be heard against the fabric of the tent.

You can see a Woven Mat, a Crackling Fire, an Insidious Artifact, an Essence of the Jungle Toad, a Stone Totem, a Leather Lockbox (empty) and a Lifebind Necklace here.

>get in woven mat
You just need some sleep.  The evil spirit wants your help to destroy the village, but you can't bring yourself to do it.  The cat won't hurt you... you are just as evil on the inside as it is.  You just have a semblance of self-control.  Maybe time for some more Essence of the Jungle Toad.

    *** The End ***

Would you like to RESTART, RESTORE a saved game, QUIT or UNDO the last command?

>undo
Shaman's Hut
[Previous turn undone.]

>l
Shaman's Hut
The hut has no furniture, and your important possessions are placed neatly on the floor.  A fire is crackling and the yearning starlight filters through the smoke chimney in your roof.  Local insects chirp and the sound of a rushing wind can be heard against the fabric of the tent.

You can see a Woven Mat, a Crackling Fire, an Insidious Artifact, an Essence of the Jungle Toad, a Stone Totem, a Leather Lockbox (empty) and a Lifebind Necklace here.

>take insidious artifact
Taken.

>n
Your dark ally looks at you, then runs toward the path to the village where you were born.

>w
You have tread this path many times.  You almost feel as if you cannot stop yourself, and that you are being led to an unwanted fate. Nonetheless, it feels right.  Perhaps this spirit isn't so dark, and these humans deserve death.  Your lover should have come after you. Your parents should have intervented and saved you. The other townspeople? What do you care about those?  It is time to follow the jungle cat into the village and take action.

>w
Path to the Painted Village
Seeing this place brings back both good and bad memories.  No more than sixty or seventy reside here, and surely your parents and former lover are among them.  You wonder if the old Shaman who once exiled you is still alive.  A deep and commanding voice fills your head.  It does not speak in clear words, but you understand what it wants you to do.  The spirit has already bound the souls of the entire village to the Bone Effigy.  It is up to you to deal with them.  A fierce image of the Insidious Artifact manifests itself in your mind, and visions of purple flame and screaming souls overwhelm you. You know what to do.

You can see Baby Jungle Panther and a Fleshy Root here.

>incinerate bone effigy
You wouldn't release the purple flame of this instrument onto an item you value.

You engulf the effigy in the blast of violet energy from the ancient artifact.  Simultaneously, screams rise as a purple inferno erupts from inside the body of each person in the village.  You watch in horror and glee as townsfolk crash to the ground, their bodies turned to dust. A familar face flashes in front of your eyes... your lover! It is she! A violet heart shatters within her soul right in front you, and she falls to the ground.  Your eyes meet one final time.  What have you done?

    *** The End ***

Would you like to RESTART, RESTORE a saved game, QUIT or UNDO the last command?

* * *

>take insidious artifact
Taken.

>incinerate bone effigy
You wouldn't release the purple flame of this instrument onto an item you value.

* * *

>touch totem
You immediately feel invigorated by the energy emitted through the pale rock.  Suddenly you feel that you could stand up, albeit carefully.  The totem itself looks brighter than usual....that indicates that perhaps Windwhisper has come to visit.

>stand
You get off the Woven Mat.

Shaman's Hut
The hut has no furniture, and your important possessions are placed neatly on the floor.  A fire is crackling and the yearning starlight filters through the smoke chimney in your roof.  Local insects chirp and the sound of a rushing wind can be heard against the fabric of the tent.

You can see a Woven Mat, a Crackling Fire, an Insidious Artifact, a Bone Effigy, an Essence of the Jungle Toad, a Stone Totem, a Leather Lockbox (closed) and a Lifebind Necklace here.

>open box
You can't see any such thing.

>open lockbox
You open the Leather Lockbox, revealing a Transient Orb.

>take orb
Taken.

A small, wounded Baby Jungle Panther slinks through the doorway to your hut.  It's back is wounded and bloody, and it limps pathetically toward you.  Its eyes are full of confusion and desperation.

>take lifebind necklace
The necklace disintegrates before your eyes as you bring it near the jungle cat.

Suddenly, you feel sure that this is a dark ancestral spirit inhabiting the body of this unfortunate jungle panther, and that it jealously desires the destruction of those living.  But something tells you this dark spirit is not here for your LIFE, but something else...It's time to make a move.

>attack cat
The cat reacts swiftly and swats all of your reminaing Essence of the Jungle Toad into the Crackling Fire.  The entire batch is set alight and your hut begins to fill with an overbearing smell that you know all too well.  You reach out to grab the cat, but before you can do anything a wave of ethereal images and voices assails your mind.  Before all goes dark, you feel a pang of fear as you realize just how much Essence you have inhaled... nearly one hundred fold the reccomended amount.

Shaman's Hut (on the Woven Mat)
The hut has no furniture, and your important possessions are placed neatly on the floor.  A fire is crackling and the yearning starlight filters through the smoke chimney in your roof.  Local insects chirp and the sound of a rushing wind can be heard against the fabric of the tent.

You can see a Crackling Fire, a Stone Totem and a Leather Lockbox (empty) here.

>go north
(first getting off the Woven Mat)
You slowly snap back to reality, as otherworldy clouds, voices, and colors in your mind's eye fade.  It is night once again.  You experience a strange feeling of Deja Vu due to waking up from what was the most intense vision quest you have ever experienced.  In fact, you barely remember any of it... you just know it was more powerful than any other you've had. Something in your soul feels fundamentally altered.  You feel an odd mix of terror, vengeance, and urgency; suddenly you recall past events with the supposed panther. You look around in panic as you notice your Bone Effigy and Insidious Artifact are missing. You feel an additional spike of confusion as your solar calculations tell you that days have passed since you were last awake.

Jungle Enclave
You can feel the pulse of the jungle's raw mass of life in your bones.  Somewhere deep in your mind you are aware of the jungle denizen's hopeless struggle for prolonged existence.  Beasts, insects, and humans combined radiate out a desperate energy from their souls that you have learned to tune out.

>go west
The Path to the Painted Village
This path leads to the village where you were born, and were exiled from long ago.

You can see a Fleshy Root here.

>west
Village
Purple flame and smoke ravage the landscape.  A scent of death and soul energy tinges your nose.  You are days too late, and the dark spirit has already used your items to incinerate everyone here. Your heart sinks as you realize what has happened. However, you are shortly assailed by an irrestible surge of victory. Tension built up for years is released as you realize the ties to your past have been cut. 

You can see an Insidious Artifact here.

>go east
The Path to the Painted Village
This path leads to the village where you were born, and were exiled from long ago.

You can see a Fleshy Root here.

>go east
Jungle Enclave
You can feel the pulse of the jungle's raw mass of life in your bones.  Somewhere deep in your mind you are aware of the jungle denizen's hopeless struggle for prolonged existence.  Beasts, insects, and humans combined radiate out a desperate energy from their souls that you have learned to tune out.

>go south
Shaman's Hut
The hut has no furniture, and your important possessions are placed neatly on the floor.  A fire is crackling and the yearning starlight filters through the smoke chimney in your roof.  Local insects chirp and the sound of a rushing wind can be heard against the fabric of the tent.

You can see a Woven Mat, a Crackling Fire, a Stone Totem and a Leather Lockbox (empty) here.

>get in mat
You get onto the Woven Mat.

* * *

>stand
You get off the Woven Mat.

Shaman's Hut
The hut has no furniture, and your important possessions are placed neatly on the floor.  A fire is crackling and the yearning starlight filters through the smoke chimney in your roof.  Local insects chirp and the sound of a rushing wind can be heard against the fabric of the tent.

You can see a Woven Mat, a Crackling Fire, an Insidious Artifact, a Bone Effigy, an Essence of the Jungle Toad, a Stone Totem, a Leather Lockbox (closed) and a Lifebind Necklace here.

>unlock box
You can't see any such thing.

>unlock lockbox
You open the Leather Lockbox, revealing a Transient Orb.

>take orb
Taken.

A small, wounded Baby Jungle Panther slinks through the doorway to your hut.  It's back is wounded and bloody, and it limps pathetically toward you.  Its eyes are full of confusion and desperation.

>capture cat
Attack it with what? It is already injured enough as is! That could result in a bite, also. A dark thought pops into to mind for just one moment...You could always incinerate it. You push the thought down to a deeper part of your consciousness.

* * *

>open leather lockbox
You open the Leather Lockbox, revealing a Transient Orb.

>take orb
Taken.

A small, wounded Baby Jungle Panther slinks through the doorway to your hut.  It's back is wounded and bloody, and it limps pathetically toward you.  Its eyes are full of confusion and desperation.

* * *

>take lifebind necklace
The necklace disintegrates before your eyes as you bring it near the jungle cat.

Suddenly, you feel sure that this is a dark ancestral spirit inhabiting the body of this unfortunate jungle panther, and that it jealously desires the destruction of those living.  But something tells you this dark spirit is not here for your LIFE, but something else...It's time to make a move.

>kick cat
The cat reacts swiftly and swats all of your reminaing Essence of the Jungle Toad into the Crackling Fire.  The entire batch is set alight and your hut begins to fill with an overbearing smell that you know all too well.  You reach out to grab the cat, but before you can do anything a wave of ethereal images and voices assails your mind.  Before all goes dark, you feel a pang of fear as you realize just how much Essence you have inhaled... nearly one hundred fold the reccomended amount.

Shaman's Hut (on the Woven Mat)
The hut has no furniture, and your important possessions are placed neatly on the floor.  A fire is crackling and the yearning starlight filters through the smoke chimney in your roof.  Local insects chirp and the sound of a rushing wind can be heard against the fabric of the tent.

You can see a Crackling Fire, a Stone Totem and a Leather Lockbox (empty) here.

>touch totem
You immediately feel invigorated by the energy emitted through the pale rock.  Suddenly you feel that you could stand up, albeit carefully.  The totem itself looks brighter than usual....that indicates that perhaps Windwhisper has come to visit.

>stand
You slowly snap back to reality, as otherworldy clouds, voices, and colors in your mind's eye fade.  It is night once again.  You experience a strange feeling of Deja Vu due to waking up from what was the most intense vision quest you have ever experienced.  In fact, you barely remember any of it... you just know it was more powerful than any other you've had. Something in your soul feels fundamentally altered.  You feel an odd mix of terror, vengeance, and urgency; suddenly you recall past events with the supposed panther. You look around in panic as you notice your Bone Effigy and Insidious Artifact are missing. You feel an additional spike of confusion as your solar calculations tell you that days have passed since you were last awake.

>examine transient orb
It is a spherical object to commune with ancestral spirits for advice. All who call themselves a shaman in these lands possess one of these, for what is a shaman without ancestors to call upon?  Anyone with basic knowledge of shamanism could make one of these out of any object.  It is usually the color of earth, but can also turn black as night when it detects malignant intentions in those whose auras are clearly altered by their attempts to lie or deceive. Right now, your orb is black.

>go north
Jungle Enclave
You can feel the pulse of the jungle's raw mass of life in your bones.  Somewhere deep in your mind you are aware of the jungle denizen's hopeless struggle for prolonged existence.  Beasts, insects, and humans combined radiate out a desperate energy from their souls that you have learned to tune out.

>go west
The Path to the Painted Village
This path leads to the village where you were born, and were exiled from long ago.

You can see a Fleshy Root here.

>go west
Village
Purple flame and smoke ravage the landscape.  A scent of death and soul energy tinges your nose.  Your heart sinks as you realize what has happened, but a small smile appears on your face.

You can see an Insidious Artifact here.

* * *

>stand
You get off the Woven Mat.

Shaman's Hut
The hut has no furniture, and your important possessions are placed neatly on the floor.  A fire is crackling and the yearning starlight filters through the smoke chimney in your roof.  Local insects chirp and the sound of a rushing wind can be heard against the fabric of the tent.

You can see a Woven Mat, a Crackling Fire, an Insidious Artifact, a Bone Effigy, an Essence of the Jungle Toad, a Stone Totem, a Leather Lockbox (closed) and a Lifebind Necklace here.

>open lockbox
You open the Leather Lockbox, revealing a Transient Orb.

>take boen effigy
You can't see any such thing.

>take effigy
You'd prefer not to grab that if you don't have to. It is an object of undescribable evil and it unnerves you to touch it. Yet, you keep it near by just in case....

>examine transient orb
It is a spherical object to commune with ancestral spirits for advice. All who call themselves a shaman in these lands possess one of these, for what is a shaman without ancestors to call upon?  Anyone with basic knowledge of shamanism could make one of these out of any object.  It is usually the color of earth, but can also turn black as night when it detects malignant intentions in those whose auras are clearly altered by their attempts to lie or deceive. Right now, your orb is earthen.

>take bone effigy
You'd prefer not to grab that if you don't have to. It is an object of undescribable evil and it unnerves you to touch it. Yet, you keep it near by just in case....

>take orb
Taken.

A small, wounded Baby Jungle Panther slinks through the doorway to your hut.  It's back is wounded and bloody, and it limps pathetically toward you.  Its eyes are full of confusion and desperation.

>take bone effigy
Your soul trembles at the sheer evil of this human shaped fetish.

>examine orb
It is a spherical object to commune with ancestral spirits for advice. All who call themselves a shaman in these lands possess one of these, for what is a shaman without ancestors to call upon?  Anyone with basic knowledge of shamanism could make one of these out of any object.  It is usually the color of earth, but can also turn black as night when it detects malignant intentions in those whose auras are clearly altered by their attempts to lie or deceive. Right now, your orb is black. 

A wave of confusion washes over you as you witness the abyssal color of your orb.  There must be evil nearby.  As you turn to look at the devious feline, you meet it's eyes and realize all too late what has happened. It gives you an oddly human look that tells you all you need to know.

Suddenly, you feel sure that this is a dark ancestral spirit inhabiting the body of this unfortunate jungle panther, and that it jealously desires the destruction of those living.  But something about the intruder's aural energy tells you this dark spirit is not here for your LIFE, but something else...It's time to make a move.

>give effigy
(to Baby Jungle Panther)
(first taking the Bone Effigy)
Baby Jungle Panther doesn't seem interested.

You share a glance of dark understanding with the being that stands before you.  It is time for vengeance against those who once spurned you.  The cat runs out of your hut and beckons for you to follow.

>n
Your dark ally looks at you, then runs west toward the path to the village where you were born.

>w
You have tread this path many times.  You almost feel as if you cannot stop yourself, and that you are being led to an unwanted fate. Nonetheless, it feels right.  Perhaps this spirit isn't so dark, and these humans deserve death.  Your lover should have come after you. Your parents should have intervented and saved you. The other townspeople? What do you care about those?  It is time to follow the jungle cat into the village and take action.

The Path to the Painted Village
This path leads to the village where you were born, and were exiled from long ago.

You can see a Fleshy Root here.

>go w
Village
Seeing this place brings back both good and bad memories.  No more than sixty or seventy reside here, and surely your parents and former lover are among them.  You wonder if the old Shaman who once exiled you is still alive.  A deep and commanding voice fills your head.  It does not speak in clear words, but you understand what it wants you to do.  The spirit has already bound the souls of the entire village to the Bone Effigy.  It is up to you to deal with them.  A fierce image of the Insidious Artifact manifests itself in your mind, and visions of purple flame and screaming souls overwhelm you. You know what to do.

You can see Baby Jungle Panther here.

* * *

>take orb
Taken.

A small, wounded Baby Jungle Panther slinks through the doorway to your hut.  It's back is wounded and bloody, and it limps pathetically toward you.  Its eyes are full of confusion and desperation.

>examine orb
It is a spherical object to commune with ancestral spirits for advice. All who call themselves a shaman in these lands possess one of these, for what is a shaman without ancestors to call upon?  Anyone with basic knowledge of shamanism could make one of these out of any object.  It is usually the color of earth, but can also turn black as night when it detects malignant intentions in those whose auras are clearly altered by their attempts to lie or deceive. Right now, your orb is black. 

A wave of confusion washes over you as you witness the abyssal color of your orb.  There must be evil nearby.  As you turn to look at the devious feline, you meet it's eyes and realize all too late what has happened. It gives you an oddly human look that tells you all you need to know.

Suddenly, you feel sure that this is a dark ancestral spirit inhabiting the body of this unfortunate jungle panther, and that it jealously desires the destruction of those living.  But something about the intruder's aural energy tells you this dark spirit is not here for your LIFE, but something else...It's time to make a move.

>kick cat
The cat reacts swiftly and swats all of your reminaing Essence of the Jungle Toad into the Crackling Fire.  The entire batch is set alight and your hut begins to fill with an overbearing smell that you know all too well.  You reach out to grab the cat, but before you can do anything a wave of ethereal images and voices assails your mind.  Before all goes dark, you feel a pang of fear as you realize just how much Essence you have inhaled... nearly one hundred fold the reccomended amount.

Shaman's Hut (on the Woven Mat)
The hut has no furniture, and your important possessions are placed neatly on the floor.  A fire is crackling and the yearning starlight filters through the smoke chimney in your roof.  Local insects chirp and the sound of a rushing wind can be heard against the fabric of the tent.

You can see a Crackling Fire, a Stone Totem, a Leather Lockbox (empty) and a Lifebind Necklace here.

>go north
(first getting off the Woven Mat)
You slowly snap back to reality, as otherworldy clouds, voices, and colors in your mind's eye fade.  It is night once again.  You experience a strange feeling of Deja Vu due to waking up from what was the most intense vision quest you have ever experienced.  In fact, you barely remember any of it... you just know it was more powerful than any other you've had. Something in your soul feels fundamentally altered.  You feel an odd mix of terror, vengeance, and urgency; suddenly you recall past events with the supposed panther. You look around in panic as you notice your Bone Effigy and Insidious Artifact are missing. You feel an additional spike of confusion as your solar calculations tell you that days have passed since you were last awake.

Jungle Enclave
You can feel the pulse of the jungle's raw mass of life in your bones.  Somewhere deep in your mind you are aware of the jungle denizen's hopeless struggle for prolonged existence.  Beasts, insects, and humans combined radiate out a desperate energy from their souls that you have learned to tune out.

* * *

>go west
The Path to the Painted Village
This path leads to the village where you were born, and were exiled from long ago.

You can see a Fleshy Root here.

>west
Village
Purple flame and smoke ravage the landscape.  A scent of death and soul energy tinges your nose.  You are days too late, and the dark spirit has already used your Insidious Artifact on the Bone Effigy to incinerate everyone here. Your heart sinks as you realize that you have been bested by the dark spirit. However, you are shortly assailed by an irrestible surge of victory. Tension built up for years is released as you realize the ties to your past have been cut. 

You can see an Insidious Artifact here.

>go west
You can't go that way.

* * *

>grab cat
That's not a verb I recognise.

>approach cat
The cat reacts swiftly and swats all of your reminaing Essence of the Jungle Toad into the Crackling Fire.  The entire batch is set alight and your hut begins to fill with an overbearing smell that you know all too well.  You reach out to grab the cat, but before you can do anything a wave of ethereal images and voices assails your mind.  Before all goes dark, you feel a pang of fear as you realize just how much Essence you have inhaled... nearly one hundred fold the reccomended amount.

Shaman's Hut (on the Woven Mat)
The hut has no furniture, and your important possessions are placed neatly on the floor.  A fire is crackling and the yearning starlight filters through the smoke chimney in your roof.  Local insects chirp and the sound of a rushing wind can be heard against the fabric of the tent.

You can see a Crackling Fire, a Stone Totem, a Leather Lockbox (empty) and a Lifebind Necklace here.

>n
(first getting off the Woven Mat)
You slowly snap back to reality, as otherworldy clouds, voices, and colors in your mind's eye fade.  It is night once again.  You experience a strange feeling of Deja Vu due to waking up from what was the most intense vision quest you have ever experienced.  In fact, you barely remember any of it... you just know it was more powerful than any other you've had. Something in your soul feels fundamentally altered.  You feel an odd mix of terror, vengeance, and urgency; suddenly you recall past events with the supposed panther. You look around in panic as you notice your Bone Effigy and Insidious Artifact are missing. You feel an additional spike of confusion as your solar calculations tell you that days have passed since you were last awake.

Jungle Enclave
You can feel the pulse of the jungle's raw mass of life in your bones.  Somewhere deep in your mind you are aware of the jungle denizen's hopeless struggle for prolonged existence.  Beasts, insects, and humans combined radiate out a desperate energy from their souls that you have learned to tune out.

>w
The Path to the Painted Village
This path leads to the village where you were born, and were exiled from long ago.

You can see a Fleshy Root here.

>w
Village
Purple flame and smoke ravage the landscape.  A scent of death and soul energy tinges your nose.  You are days too late, and the dark spirit has already used your Insidious Artifact on the Bone Effigy to incinerate everyone here. Your heart sinks as you realize that you have been bested by the dark spirit. However, you are shortly assailed by an irrestible surge of victory. Tension built up for years is released as you realize the ties to your past have been cut. 

You can see an Insidious Artifact here.

>take insidious artifact
    *** The End ***

Would you like to RESTART, RESTORE a saved game, QUIT or UNDO the last command?

* * *

>give effigy
(to Baby Jungle Panther)
(first taking the Bone Effigy)
Baby Jungle Panther doesn't seem interested.

You share a glance of dark understanding with the being that stands before you.  It is time for vengeance against those who once spurned you.  The cat runs out of your hut and beckons for you to follow.

>go north
Your dark ally looks at you, then runs west toward the path to the village where you were born.

Jungle Enclave
You can feel the pulse of the jungle's raw mass of life in your bones.  Somewhere deep in your mind you are aware of the jungle denizen's hopeless struggle for prolonged existence.  Beasts, insects, and humans combined radiate out a desperate energy from their souls that you have learned to tune out. 

You can see Windwhisper here.

>go west
You have tread this path many times.  You almost feel as if you cannot stop yourself, and that you are being led to an unwanted fate. Nonetheless, it feels right.  Perhaps this spirit isn't so dark, and these humans deserve death.  Your lover should have come after you. Your parents should have intervented and saved you. The other townspeople? What do you care about those?  It is time to follow the jungle cat into the village and take action.

The Path to the Painted Village
This path leads to the village where you were born, and were exiled from long ago.

You can see a Fleshy Root here.

>go west
Village
Seeing this place brings back both good and bad memories.  No more than sixty or seventy reside here, and surely your parents and former lover are among them.  You wonder if the old Shaman who once exiled you is still alive.  A deep and commanding voice fills your head.  It does not speak in clear words, but you understand what it wants you to do.  The spirit has already bound the souls of the entire village to the Bone Effigy.  It is up to you to deal with them.  A fierce image of the Insidious Artifact manifests itself in your mind, and visions of purple flame and screaming souls overwhelm you. You know what to do.

You can see Baby Jungle Panther here.

>go east
The Path to the Painted Village
This path leads to the village where you were born, and were exiled from long ago.

You can see a Fleshy Root here.

>go east
Jungle Enclave
You can feel the pulse of the jungle's raw mass of life in your bones.  Somewhere deep in your mind you are aware of the jungle denizen's hopeless struggle for prolonged existence.  Beasts, insects, and humans combined radiate out a desperate energy from their souls that you have learned to tune out. 

You can see Windwhisper here.

>go south
Shaman's Hut
The hut has no furniture, and your important possessions are placed neatly on the floor.  A fire is crackling and the yearning starlight filters through the smoke chimney in your roof.  Local insects chirp and the sound of a rushing wind can be heard against the fabric of the tent.

You can see a Woven Mat, a Crackling Fire, an Insidious Artifact, an Essence of the Jungle Toad, a Stone Totem, a Leather Lockbox (empty) and a Lifebind Necklace here.

>enter woven mat
You just need some sleep.  The evil spirit wants your help to destroy the village, but you can't bring yourself to do it.  The cat won't hurt you... you are just as evil on the inside as it is.  You just have a semblance of self-control.  Maybe time for some more Essence of the Jungle Toad.

    *** The End ***

Would you like to RESTART, RESTORE a saved game, QUIT or UNDO the last command?

>restart
Whatever progress you had made in this night's vision is forgotten to you by now, and your illusionary avatar is fading from your mind's eye. Bright colors flash and flow before your eyes as you sink back to reality. You open your eyes and you can see the carved ceiling of your hut.  You are lying on the ground in the center of the hut, and feel incredibly weak and drowsy. You have awakened far too early from your vision quest, and need to rest before trying to move. 
Lifebound
An Interactive Fiction by Benjamin Strick
Release 1 / Serial number 150422 / Inform 7 build 6L38 (I6/v6.33 lib 6/12N) SD

Shaman's Hut (on the Woven Mat)
The hut has no furniture, and your important possessions are placed neatly on the floor.  A fire is crackling and the yearning starlight filters through the smoke chimney in your roof.  Local insects chirp and the sound of a rushing wind can be heard against the fabric of the tent.

You can see a Crackling Fire, an Insidious Artifact, a Bone Effigy, an Essence of the Jungle Toad, a Stone Totem, a Leather Lockbox (closed) and a Lifebind Necklace here.

>touch totem
You immediately feel invigorated by the energy emitted through the pale rock.  Suddenly you feel that you could stand up, albeit carefully.  The totem itself looks brighter than usual....that indicates that perhaps Windwhisper has come to visit.

* * *

>give effigy
(to Baby Jungle Panther)
(first taking the Bone Effigy)
Baby Jungle Panther doesn't seem interested.

You share a glance of dark understanding with the being that stands before you.  It is time for vengeance against those who once spurned you.  The cat runs out of your hut and beckons for you to follow.

>go n
Your dark ally looks at you, then runs west toward the path to the village where you were born.

Jungle Enclave
You can feel the pulse of the jungle's raw mass of life in your bones.  Somewhere deep in your mind you are aware of the jungle denizen's hopeless struggle for prolonged existence.  Beasts, insects, and humans combined radiate out a desperate energy from their souls that you have learned to tune out. 

You can see Windwhisper here.

>go w
You have tread this path many times.  You almost feel as if you cannot stop yourself, and that you are being led to an unwanted fate. Nonetheless, it feels right.  Perhaps this spirit isn't so dark, and these humans deserve death.  Your lover should have come after you. Your parents should have intervented and saved you. The other townspeople? What do you care about those?  It is time to follow the jungle cat into the village and take action.

The Path to the Painted Village
This path leads to the village where you were born, and were exiled from long ago.

You can see a Fleshy Root here.

>eat fleshy root
(first taking the Fleshy Root)
After consuming the bitter root, you can feel an abstract shield of power come together across your body and soul. This natural ingredient is truly amazing and will shield you from dark spirits for a few hours.

>go w
Village
Seeing this place brings back both good and bad memories.  No more than sixty or seventy reside here, and surely your parents and former lover are among them.  You wonder if the old Shaman who once exiled you is still alive.  A deep and commanding voice fills your head.  It does not speak in clear words, but you understand what it wants you to do.  The spirit has already bound the souls of the entire village to the Bone Effigy.  It is up to you to deal with them.  A fierce image of the Insidious Artifact manifests itself in your mind, and visions of purple flame and screaming souls overwhelm you. You know what to do.

You can see Baby Jungle Panther here.

>incinerate cat
You need the Insidious Artifact to incinerate something.

>go e
The Path to the Painted Village
This path leads to the village where you were born, and were exiled from long ago.

>go e
Jungle Enclave
You can feel the pulse of the jungle's raw mass of life in your bones.  Somewhere deep in your mind you are aware of the jungle denizen's hopeless struggle for prolonged existence.  Beasts, insects, and humans combined radiate out a desperate energy from their souls that you have learned to tune out. 

You can see Windwhisper here.

>s
Shaman's Hut
The hut has no furniture, and your important possessions are placed neatly on the floor.  A fire is crackling and the yearning starlight filters through the smoke chimney in your roof.  Local insects chirp and the sound of a rushing wind can be heard against the fabric of the tent.

You can see a Woven Mat, a Crackling Fire, an Insidious Artifact, an Essence of the Jungle Toad, a Stone Totem, a Leather Lockbox (empty) and a Lifebind Necklace here.

>take artifact
Taken.

>n
Your dark ally looks at you, then runs west toward the path to the village where you were born.

Jungle Enclave
You can feel the pulse of the jungle's raw mass of life in your bones.  Somewhere deep in your mind you are aware of the jungle denizen's hopeless struggle for prolonged existence.  Beasts, insects, and humans combined radiate out a desperate energy from their souls that you have learned to tune out. 

You can see Windwhisper here.

>w
You have tread this path many times.  You almost feel as if you cannot stop yourself, and that you are being led to an unwanted fate. Nonetheless, it feels right.  Perhaps this spirit isn't so dark, and these humans deserve death.  Your lover should have come after you. Your parents should have intervented and saved you. The other townspeople? What do you care about those?  It is time to follow the jungle cat into the village and take action.

The Path to the Painted Village
This path leads to the village where you were born, and were exiled from long ago.

>w
Village
Seeing this place brings back both good and bad memories.  No more than sixty or seventy reside here, and surely your parents and former lover are among them.  You wonder if the old Shaman who once exiled you is still alive.  A deep and commanding voice fills your head.  It does not speak in clear words, but you understand what it wants you to do.  The spirit has already bound the souls of the entire village to the Bone Effigy.  It is up to you to deal with them.  A fierce image of the Insidious Artifact manifests itself in your mind, and visions of purple flame and screaming souls overwhelm you. You know what to do.

You can see Baby Jungle Panther here.

>incinerate cat
You attempt to savagely burn the body of the Baby Jungle Panther with the Insidious Artifact.  The body evaporates in the inferno instantly, but a formless shape arises from where the cat once was.  However, after ingesting the strange power of the Fleshy Root, you are spirit protected.  You can sense the presence of the dying ancestor as it tries to crawl its way into your mind and soul.  Had you not stopped to eat the root, you know you would have met a morbid fate by now at the hands of this vengeful spirit.  Although conspiring with it to take vengeance upon those who wronged you in your past seemed appetizing, something within you knew that this malevolent being had to be stopped.

    *** The End ***

Would you like to RESTART, RESTORE a saved game, QUIT or UNDO the last command?

* * *

>use orb
It is a spherical object to commune with ancestral spirits for advice. All who call themselves a shaman in these lands possess one of these, for what is a shaman without ancestors to call upon?  Anyone with basic knowledge of shamanism could make one of these out of any object.  It is usually the color of earth, but can also turn black as night when it detects malignant intentions in those whose auras are clearly altered by their attempts to lie or deceive. Right now, your orb is black.

>go north
You should deal with this deceptive dark spirit that seeks the power of your rare soul magic first.

>bind cat
The cat reacts swiftly and swats all of your reminaing Essence of the Jungle Toad into the Crackling Fire.  The entire batch is set alight and your hut begins to fill with an overbearing smell that you know all too well.  You reach out to grab the cat, but before you can do anything a wave of ethereal images and voices assails your mind.  Before all goes dark, you feel a pang of fear as you realize just how much Essence you have inhaled... nearly one hundred fold the reccomended amount.

Shaman's Hut (on the Woven Mat)
The hut has no furniture, and your important possessions are placed neatly on the floor.  A fire is crackling and the yearning starlight filters through the smoke chimney in your roof.  Local insects chirp and the sound of a rushing wind can be heard against the fabric of the tent.

You can see a Crackling Fire, a Stone Totem, a Leather Lockbox (empty) and a Lifebind Necklace here.

>n
(first getting off the Woven Mat)
You slowly snap back to reality, as otherworldy clouds, voices, and colors in your mind's eye fade.  It is night once again.  You experience a strange feeling of Deja Vu due to waking up from what was the most intense vision quest you have ever experienced.  In fact, you barely remember any of it... you just know it was more powerful than any other you've had. Something in your soul feels fundamentally altered.  You feel an odd mix of terror, vengeance, and urgency; suddenly you recall past events with the supposed panther. You look around in panic as you notice your Bone Effigy and Insidious Artifact are missing. You feel an additional spike of confusion as your solar calculations tell you that days have passed since you were last awake.

Jungle Enclave
You can feel the pulse of the jungle's raw mass of life in your bones.  Somewhere deep in your mind you are aware of the jungle denizen's hopeless struggle for prolonged existence.  Beasts, insects, and humans combined radiate out a desperate energy from their souls that you have learned to tune out.

>s
Shaman's Hut
The hut has no furniture, and your important possessions are placed neatly on the floor.  A fire is crackling and the yearning starlight filters through the smoke chimney in your roof.  Local insects chirp and the sound of a rushing wind can be heard against the fabric of the tent.

You can see a Woven Mat, a Crackling Fire, a Stone Totem, a Leather Lockbox (empty) and a Lifebind Necklace here.

>enter woven mat
You just need some sleep.  Perhaps the loss of those destructive items is a good thing for you.  Did the spirit perhaps use them to destroy your old village? You don't care one way or another.  Going outside to investigate would just mean more problems. Maybe time for some more Essence of the Jungle Toad.

    *** The End ***

Would you like to RESTART, RESTORE a saved game, QUIT or UNDO the last command?

* * *

>take orb
Taken.

A small, wounded Baby Jungle Panther slinks through the doorway to your hut.  It's back is wounded and bloody, and it limps pathetically toward you.  Its eyes are full of confusion and desperation.

>use necklace
I didn't understand that sentence.

>give necklace
(to Baby Jungle Panther)
(first taking the Lifebind Necklace)
The necklace disintegrates before your eyes as you bring it near the jungle cat.  Only an evil aura could break the soul magic involved in such an item.

Suddenly, you feel sure that this is a dark ancestral spirit inhabiting the body of this unfortunate jungle panther, and that it jealously desires the destruction of those living.  But something about the intruder's aural energy tells you this dark spirit is not here for your LIFE, but something else...It's time to make a move.

>give effigy
(to Baby Jungle Panther)
(first taking the Bone Effigy)
Baby Jungle Panther doesn't seem interested.

You share a glance of dark understanding with the being that stands before you.  It is time for vengeance against those who once spurned you.  The cat runs out of your hut and beckons for you to follow.

>n
Your dark ally looks at you, then runs west toward the path to the village where you were born.

Jungle Enclave
You can feel the pulse of the jungle's raw mass of life in your bones.  Somewhere deep in your mind you are aware of the jungle denizen's hopeless struggle for prolonged existence.  Beasts, insects, and humans combined radiate out a desperate energy from their souls that you have learned to tune out. 

You can see Windwhisper here.

>w
You have tread this path many times.  You almost feel as if you cannot stop yourself, and that you are being led to an unwanted fate. Nonetheless, it feels right.  Perhaps this spirit isn't so dark, and these humans deserve death.  Your lover should have come after you. Your parents should have intervented and saved you. The other townspeople? What do you care about those?  It is time to follow the jungle cat into the village and take action.

The Path to the Painted Village
This path leads to the village where you were born, and were exiled from long ago.

You can see a Fleshy Root here.

>w
Village
Seeing this place brings back both good and bad memories.  No more than sixty or seventy reside here, and surely your parents and former lover are among them.  You wonder if the old Shaman who once exiled you is still alive.  A deep and commanding voice fills your head.  It does not speak in clear words, but you understand what it wants you to do.  The spirit has already bound the souls of the entire village to the Bone Effigy.  It is up to you to deal with them.  A fierce image of the Insidious Artifact manifests itself in your mind, and visions of purple flame and screaming souls overwhelm you. You know what to do.

You can see Baby Jungle Panther here.

>incinerate bone effigy
You need the Insidious Artifact to incinerate something.

>inv
You are carrying:
  a Bone Effigy
  a Transient Orb
  a Buffalo Hide Robe (being worn)

>restart
Are you sure you want to restart?

* * *

>take orb
Taken.

A small, wounded Baby Jungle Panther slinks through the doorway to your hut.  It's back is wounded and bloody, and it limps pathetically toward you.  Its eyes are full of confusion and desperation.

>take necklace
The necklace disintegrates before your eyes as you bring it near the jungle cat.  Only an evil aura could break the soul magic involved in such an item.

Suddenly, you feel sure that this is a dark ancestral spirit inhabiting the body of this unfortunate jungle panther, and that it jealously desires the destruction of those living.  But something about the intruder's aural energy tells you this dark spirit is not here for your LIFE, but something else...It's time to make a move.

>give effigy
(to Baby Jungle Panther)
(first taking the Bone Effigy)
Baby Jungle Panther doesn't seem interested.

You share a glance of dark understanding with the being that stands before you.  It is time for vengeance against those who once spurned you.  The cat runs out of your hut and beckons for you to follow.

* * *

>examine essence of the jungle toad
This controversial substance is used to engage on psychedelic spirit journeys.  Local toads with bright coloring have been used for this purpose for as long as anyone can remember.  One must burn the toad's skin and inhale the residue to get the desired effect…. Some spiritual visions can last for days.  This type of use is not for the faint of heart however, and is generally shunned by common-folk along with other potentially evil things.

>stand
You are too drowsy from your unfinished vision to stand yet.  There are lingering colors blinking in and out of existence, and the eerie whispers of lost ancestors still echo in your mind.

>grab
(the Buffalo Hide Robe)
Violence isn't the answer to this one.

>capture
(the Buffalo Hide Robe)
Violence isn't the answer to this one.

>inspect insidous artifact
That's not a verb I recognise.

>inspect insidious artifact
That's not a verb I recognise.

>examine insidious artifact
A remnant of an ancient time that can be used to cause a burst of shadowy purple flame, incinerating flesh and bone alike.  You recall discovering this deep in the tomb of an primeval tribal leader during your travels. Whoever forged this unique weapon had nothing but destruction on their mind.

* * *

>burn toad
You don't need or want any more of that right now.

>touch totem
You immediately feel invigorated by the energy emitted through the pale rock.  Suddenly you feel that you could stand up, albeit carefully.  The totem itself looks brighter than usual....that indicates that perhaps Windwhisper has come to visit.

* * *

>stand
You get off the Woven Mat.

Shaman's Hut
The hut has no furniture, and your important possessions are placed neatly on the floor.  A fire is crackling and the yearning starlight filters through the smoke chimney in your roof.  Local insects chirp and the sound of a rushing wind can be heard against the fabric of the tent.

You can see a Woven Mat, a Crackling Fire, an Insidious Artifact, a Bone Effigy, an Essence of the Jungle Toad, a Stone Totem, a Leather Lockbox (closed) and a Lifebind Necklace here.

>unlock leather
You open the Leather Lockbox, revealing a Transient Orb.

>take orb
Taken.

A small, wounded Baby Jungle Panther slinks through the doorway to your hut.  It's back is wounded and bloody, and it limps pathetically toward you.  Its eyes are full of confusion and desperation.

>take necklace
The necklace disintegrates before your eyes as you bring it near the jungle cat.

Suddenly, you feel sure that this is a dark ancestral spirit inhabiting the body of this unfortunate jungle panther, and that it jealously desires the destruction of those living.  But something tells you this dark spirit is not here for your LIFE, but something else...It's time to make a move.

>kick out cat
The cat reacts swiftly and swats all of your reminaing Essence of the Jungle Toad into the Crackling Fire.  The entire batch is set alight and your hut begins to fill with an overbearing smell that you know all too well.  You reach out to grab the cat, but before you can do anything a wave of ethereal images and voices assails your mind.  Before all goes dark, you feel a pang of fear as you realize just how much Essence you have inhaled... nearly one hundred fold the reccomended amount.

Shaman's Hut (on the Woven Mat)
The hut has no furniture, and your important possessions are placed neatly on the floor.  A fire is crackling and the yearning starlight filters through the smoke chimney in your roof.  Local insects chirp and the sound of a rushing wind can be heard against the fabric of the tent.

You can see a Crackling Fire, a Stone Totem and a Leather Lockbox (empty) here.

>go north
(first getting off the Woven Mat)
You slowly snap back to reality, as otherworldy clouds, voices, and colors in your mind's eye fade.  It is night once again.  You experience a strange feeling of Deja Vu due to waking up from what was the most intense vision quest you have ever experienced.  In fact, you barely remember any of it... you just know it was more powerful than any other you've had. Something in your soul feels fundamentally altered.  You feel an odd mix of terror, vengeance, and urgency; suddenly you recall past events with the supposed panther. You look around in panic as you notice your Bone Effigy and Insidious Artifact are missing. You feel an additional spike of confusion as your solar calculations tell you that days have passed since you were last awake.

Jungle Enclave
You can feel the pulse of the jungle's raw mass of life in your bones.  Somewhere deep in your mind you are aware of the jungle denizen's hopeless struggle for prolonged existence.  Beasts, insects, and humans combined radiate out a desperate energy from their souls that you have learned to tune out.

>go west
The Path to the Painted Village
You tremble as you see the lifeless and scorched body of one you once knew so well.  Perhaps this was the only possible outcome.... was this your fault for having the bone effigy in the first place?

You can see a Fleshy Root here.

>go west
Village
Purple flame and smoke ravage the landscape.  A scent of death and soul energy tinges your nose.  You are days too late, and the dark spirit has already used your items to incinerate everyone here. Your heart sinks as you realize what has happened. However, you are shortly assailed by an irrestible surge of victory. Tension built up for years is released as you realize the ties to your past have been cut. 

You can see an Insidious Artifact here.